DISABLED-JA_OHNEABGRENZUNG = ((#AUSRUF#)? *(#JA_PREFIX#)?(#FUELLWOERTER# )*#JA_SUFFIX#|(#AUSRUF#|#FUELLWOERTER#)? *#JA_PUR#|(#AUSRUF#)? *#JA_WEAK#)
DISABLED-JA_PREFIX = (_(ja|jaa*|bitte|joo*|jou|jau|jup|jepp*|wow|na|na ?ja|klar)(_|(\.|,|:|\!) *))
ABER = (\baber\b|\ballerdings\b|\bdoch|eigentlich\b|\bin wirklichkeit|\behrlich gesagt\b|\bsondern|wobei\b|\baber\b)
ABONNEMENT = (\babos?\b|abonnement|abonniert|abonnieren)
ADJ_BILLIG = (\b(billig|preiswert|(preis|)guenstig)(|e|e[mnrs]|ere?)\b)
ADJ_TEUER = (\b(teuer|(teur|kostspielig|unbezahlbar|horrend|happig|unerschwinglich)(|e|e[mnrs]))\b)
ADRESSE = (adress(e|en)?|anschrift(en)?|telefon(-| )*(nr|nummer)|fax(-| )(nr|nummer)|internetadressen?|kontakt|wohn(sitz|ort))
AENDERN = (abaender(e|t|n)|abgeaendert|abaenderung(en|\b)|abzuaendern|aender(e|t|n)|geaendert|aenderung(en|\b)|umaender(t|n)|umgeaendert|umaenderung(en|\b)|umzuaendern|umstell(e|t|en)|umstellung(en|\b)|umgestellt|((stelle|stellt|stellen) .*um)|umzustellen|umwandele|umwandl(e|t|n)|umgewandelt|umwandlung(en|\b)|veraender(e|t|n)|veraenderung(en|\b)|wechsele?|wechsle|wechsel(t|n)|gewechselt|anders|aender)
AFRIKA = (\bafrika|aegypt(en|isch)|aequatorialguine(a|s)|aethiopi(en|sch)|algeri(en|sch)|angol(a|i)|\bbenin|botsuana|burkina faso|burundi|demokratische arabische republik sahara|demokratische republik kongo|dschibuti|elfenbeinkueste|eritre(a|i)|\bgabun|\bgambia|\bghan(a|i)|\bguine(a|s)|guinea-bissau|kamerun|kap *verd(e|i)|\bkenia|\bkomor(en|i)|\blesoth(o|i)|\bliberia(nisch)?\b|\bliby(en|i)|madagaskar|malawi|\bmali(|nesi)\b|marokk(o|an)|mauretani(en|i)|maurit(ius|an)|mayotte|mosambik|namibi(a|)|niger(i|)|\bnigeria|republik kongo|\bruand(a|i)|\bsambi(a|)|sao princip(e|i)|sao tome(|i)|senegal(|i)|seychell(en|i)|sierra leon(e|i)|simbabw(e|i)|somali(a|sch)|st. helen(a|i)|sudan(|isch)|suedafrika|swasil(a|ae)nd|tansani(a|sch)|\btog(o\b|i)|\btschad(\b|i)|tunesi(en|i)|ugand(a|i)|zentralafrikanische republik|zentralafrikani|zimbabw[ei])
AGENT_FIRMA_STANDORT = (standort|firmensitz|hauptsitz|geschaeftssitz|niederlassung)
AGENTNAME = (\bBoB\b)
AKTUELL = (aktuelle|aktuellste|kuerzlich|neulich|neue.?|neueste.?|moderne.?|(neu|frisch) erschienene?.?)
ALK = (alkohol\b|\bwein\b|\bbier\b|schn(ae|a)ps|\bgin\b|wodka|\bsekt\b|bloody mary|whiske?y|portwein|likoer|martini\b|campari|champagner|hochprozentig)
ALLE = (\balle(n|m|r|s|\b)|jede(n|m|r|s|\b)|jedermann)
ALLGEMEIN = (allgemeine?.?|gemeinhin|generelle?.?|(im grossen .*ganzen)|ingesamt|pauschale?.?|universale?.?|universelle?.?|ueber(blick|sicht)|ein(stieg|fuehrung))
ALT = (\b(alte?.?|aeltere?.?|aeltlich|(archaeologische?. wertvoll)|bejahrt|betagt|fossil|greis|hochbetagt|senil|steinalt|uralt|verjaehrt)\b)
ALTER01 = (\b(01|02|03|04|05|06|07|08|09|1|2|3|4|5|6|7|8|9|\bein|zwei|drei|vier|fuenf|sechs|sieben|\bacht|neun)\b)
ALTER10 = (\b(10|11|12|13|14|15|16|17|18|19|zehn|\belf|zwoelf|dreizehn|vierzehn|fuenfzehn|sechzehn|siebzehn|achtzehn|neunzehn)\b)
ANDERE = (alternative?.?|ander(s|e.?)\b|sonstige?.|sonstwie|uebrige?.|weitere.?)
ANFANG = (anfang|start|beginn)
ANREDE_F = (frau|fraeulein|freiherrin|freifrau|miss|mistress|mrs\.?|ms\.?|madame?|mme\.?|fr\.|frau dr\.)
ANTIKE = ((antike?.?|(#SEHR#|\bso) #ALT#)( .*wertvolle?.|))
ANTWORT = (antwort|rueckaeusserung|entgegnung|botschaft|mitteilung|nachricht|erwiderung|bescheid|auskunft|beantwortung|\bbrief\b|reaktion|rueckmeldung|bestaetigung|\baussagen?\b|benachrichtigung)
ARBEITE = (arbeit(e?|est|en)|schuft(e?|est|en)|maloch(e?|st|en)|acker(e?|st|en)|schwitz(e?|st|en)|racker(e?|st|n))
ARBEITER = (arbeiter|erwerbstaetig|berufstaetig|selbstaendig|werktaetitger|angestellter|freiberufl(er|ich))
ARBEITSLOS = ((arbeit|erwerb)slos|sozialhilfeempfaenger|#NICHT# arbeite|#JOB# verloren|verlore? #JOB#)
ART_DEF = (\b(der|die|das|den|dem)\b)
ARTIKEL = ((#ART_DEF# |#ART_INDEFINITE# |)((zeitschrift(en)?|zeitungs?)?artikeln?|presseinfo(s|information(en|s))|presseberichte?|veroeffentlichung(en|)|clippings?|pressenews))
ART_INDEFINITE = (\bein(|e|e[rmns])\b)
ART_PREP = (\bbeim\b|\bzum\b|\bzur\b|\bbei der\b|\bzu dem\b|\bzu der\b)
ASIEN = (\basi(en|at)|afghani|armeni(en|sch)|aserbaidschan|bahrain|bangladesch|bhutan|\bbrunei|\bchin(a|es)|\bgeorgi(en|sch)|\bguam|\bhong *kong|\bindi(en|sch)|indonesi(en|sch)|\birak|\biran|\bisrael|\bjapan|\bjemen|jordani(en|sch)|kambodscha|\bkasach|\bkatar|kirgisistan|\bkorea|\bkuwait|\blaos|liban(on|es)|\bmacau|malaysi(a|s)|mal(e|a)div(en|is)|mongole(i|s)|myanmar|\bnepal|nordkorea|noerdliche marian(en|i)|\boman|\bost-timor|pa(|c|r)kistan|palaestin(a|i|e)|\bpalau|philippin(en?|i)|republik chin(a|e)|republik korea|saudi-arabi(en|)|singapur|sri lank(a|i|e)|suedkorea|\bsyri(en|s)|tadschikistan|taiwan|thail(a|ae)nd|\btuerk(ei|i)|turkmenistan|usbekistan|vereinigte arabische emirate|\bvietnam|volksrepublik chin(a|e|i))
AUCH = (\b(auch|desgleichen|dito|ebenfalls|ebenso|genauso|gleichfalls)\b)
AUFBAUEN = (aufbau|aufgebaut|ausbau|ausgebaut|\berstell|entsteh|entstanden|entwickel|erschaff|erzeug|herstell|hergestellt|produzier|gebaut|\bstamm|geschaffen|\bbau(en|e|te?|st|\b)|\bgemacht\b|\bmach(e|en|t|st)\b|erweiter|(ge|)fuellt|fuellen|programmier(t|en)|getextet|realisier)
AUFGABEN = (aufgaben?|pflichte?n?\b)
AUSBILDUNG = (trainn?ee?|ausbildung|ausbilden|azubi|auszubildend?er|lehrstelle|ausgebildet werden|\bfami(s)?\b|fachangestellte(r) fuer medien- und informations(dienste|berufe))
AUSRUF = (\b(hey|ey|he+|oh?(| )je|mensch|o+h*|a+h*|[ao]ch|a+u+)(\b|(\.|,|:|\!) *))
AUTOR = (autor(in(nen)?|en|)|copywriter|redakteure?|schreiber|texter|knowledge(|-| )(designer|developer)|vorsager(in(nen)?|en|)|souffleure|\bmacher(in(nen)?|en|))
AZUBI = (azubi|auszubild(ende|ung)|lehr(e|ling)|praktik(ant|um|a)|referendar|volont(aer|iat))
